QS......SR
SS......SS
..........
..WW..WW..
..W....W..
.....p....
..W....W..
..WW..WW..
SS......SS
HS......SB