P......P
........
..CCCCC.
.CCHHC..
..CHHCC.
.CCCCC..
........
....r...