Q...WW...R
..........
..WW..SW..
..S....W..
W........W
W....@...W
..W....S..
..WS..WW..
..........
H...WW...B